00000000000
01100000110
00000000000
01000000010
00011000000
00001100110
00000000000
01100000110
00000000000
01000000010
01100000100
00000000000
01000000010